13 0.867331 0.967446 0.042102 0.037271
13 0.894697 0.943220 0.042102 0.037271
13 0.922063 0.918994 0.042102 0.037271
13 0.949429 0.894768 0.042102 0.037271
13 0.976795 0.870542 0.042102 0.037271
